R 1000 700
NO ./textures/greystone.xpm
SO ./textures/colorstone.xpm
WE ./textures/redbrick.xpm
EA ./textures/mossy1.xpm
S ./textures/barrel.xpm
F 222,200,230
C 223,114,251
1111111111111111111111111111111111111111
1000000000000000000000000000000000000011
1000000000110000000000001111111111111011
1000000000110002020020001111111111111011
1000000000000000200000001111111111111011
1111111111110020002000000000000000000011
1000000000110000000000000000111111111111
1111000000000002000002000000111111111111
1111000000000000000000000001
11000002220000001100000000001
102000000000W0001100020010001
10000200000000001101010010001
11000001110101011111011110001
11110111 1110101 101111110001
11110111 1111111 111111111011
11110111111111111111111111011
11110111111111111111111111011
11110111111111111111111111011
11110000000000000000000000011
11111111111111111111111111111
